10,10,10,10,10,10,10,10,10,10,10,10,10,10,10,10,10,10,10,10,10,10,10,10,10,10
10,10,10,10,10,10,10,10,10,10,10,10,10,10,10,10,10,10,10,10,10,10,10,10,10,10
10,10,10,10,10,10,10,10,10,10,10,10,10,10,10,10,10,10,10,10,10,10,10,10,10,10
10,10,10,10,10,10,10,10,10,10,10,10,10,10,10,10,10,10,10,10,10,10,10,10,10,10
10,10,10,0,0,0,0,1,0,0,1,0,0,0,10,10,10,10,10,10,10,10,10,10,10,10
10,10,10,0,0,0,0,1,0,0,1,0,0,0,10,10,10,10,10,10,10,10,10,10,10,10
10,10,10,0,0,0,0,1,0,0,1,0,0,0,10,10,10,10,10,10,10,10,10,10,10,10
10,10,10,0,0,0,0,15,0,0,0,0,0,0,10,10,10,10,10,10,10,10,10,10,10,10
10,10,10,0,0,0,0,1,0,0,1,0,0,0,10,10,10,10,10,10,10,10,10,10,10,10
10,10,10,0,0,0,0,1,0,0,1,0,-3,0,10,10,10,10,10,10,10,10,10,10,10,10
10,10,10,0,0,0,0,1,0,0,1,0,0,0,10,10,10,10,10,10,10,10,10,10,10,10
10,10,10,0,0,0,0,10,10,10,1,10,10,10,10,10,10,10,10,10,10,10,10,10,10,10
10,10,10,0,0,0,0,10,10,10,1,10,10,10,10,10,10,10,10,10,10,10,10,10,10,10
10,10,10,0,0,0,0,10,10,10,1,10,10,10,10,10,10,10,10,10,10,10,10,10,10,10
10,10,10,1,1,15,1,10,10,10,1,10,10,10,10,10,10,10,10,10,10,10,10,10,10,10
10,10,10,0,0,0,0,0,1,0,0,0,0,0,10,10,10,10,10,10,10,10,10,10,10,10
10,10,10,0,0,0,0,0,1,0,0,0,0,0,10,10,10,10,10,10,10,10,10,10,10,10
10,10,10,0,0,0,0,0,15,0,0,0,0,0,10,10,10,10,10,10,10,10,10,10,10,10
10,10,10,0,0,0,0,0,1,0,0,0,0,0,10,10,10,10,10,10,10,10,10,10,10,10
10,10,10,0,0,0,0,0,1,0,0,0,0,0,10,10,10,10,10,10,10,10,10,10,10,10
10,10,10,10,10,10,10,10,10,10,10,10,10,10,10,10,10,10,10,10,10,10,10,10,10,10
10,10,10,10,10,10,10,10,10,10,10,10,10,10,10,10,10,10,10,10,10,10,10,10,10,10
10,10,10,10,10,10,10,10,10,10,10,10,10,10,10,10,10,10,10,10,10,10,10,10,10,10
10,10,10,10,10,10,10,10,10,10,10,10,10,10,10,10,10,10,10,10,10,10,10,10,10,10
10,10,10,10,10,10,10,10,10,10,10,10,10,10,10,10,10,10,10,10,10,10,10,10,10,10
10,10,10,10,10,10,10,10,10,10,10,10,10,10,10,10,10,10,10,10,10,10,10,10,10,10